focal,downloads,percentile,strong,weak,total,central,score
lme4,10544,99.581,271,154,425,1,2.143
nlme,1700,98.583,255,107,362,0.726,1.851
car,8977,99.497,187,110,297,0.581,1.678
mgcv,931,97.959,269,108,377,0.486,1.612
insight,2840,98.896,23,2,25,0.603,1.604
emmeans,916,97.949,35,34,69,0.515,1.514
performance,793,97.735,11,11,22,0.496,1.48
afex,257,95.913,6,12,18,0.504,1.466
glmmTMB,284,96.151,7,22,29,0.494,1.459
pbkrtest,7933,99.408,12,16,28,0.406,1.407
effects,502,97.12,8,15,23,0.391,1.367
brms,278,96.081,13,25,38,0.354,1.321
lmerTest,560,97.255,39,28,67,0.326,1.32
broom.mixed,273,96.029,7,16,23,0.332,1.297
rstanarm,283,96.137,7,29,36,0.321,1.286
sjPlot,351,96.533,3,5,8,0.296,1.263
MuMIn,239,95.736,14,8,22,0.291,1.256
ordinal,251,95.852,13,31,44,0.251,1.217
gamm4,178,95.205,6,13,19,0.249,1.204
mice,1743,98.607,55,50,105,0.188,1.204
GLMMadaptive,128,94.17,3,7,10,0.235,1.178
DHARMa,100,93.326,3,5,8,0.239,1.174
lavaan,766,97.675,93,33,126,0.133,1.16
mlmRev,77,92.283,0,10,10,0.233,1.156
RVAideMemoire,68,91.574,0,0,0,0.24,1.156
ez,91,93.028,9,3,12,0.206,1.141
robustlmm,119,93.904,0,3,3,0.2,1.139
clubSandwich,154,94.748,1,10,11,0.184,1.132
geepack,470,97.008,27,31,58,0.136,1.121
huxtable,152,94.711,4,10,14,0.157,1.106
piecewiseSEM,48,88.261,0,1,1,0.221,1.104
rockchalk,158,94.832,4,3,7,0.145,1.095
spaMM,73,92.017,3,1,4,0.173,1.095
merDeriv,104,93.462,1,5,6,0.156,1.091
RLRsim,92,93.075,6,2,8,0.15,1.085
cAIC4,78,92.366,0,1,1,0.161,1.084
HLMdiag,31,83.615,3,0,3,0.242,1.08
coxme,165,95.004,10,8,18,0.118,1.074
cplm,169,95.093,4,3,7,0.112,1.065
gee,215,95.554,13,18,31,0.101,1.064
blme,148,94.636,5,4,9,0.099,1.048
MCMCglmm,170,95.111,8,12,20,0.081,1.036
lmeInfo,51,88.82,2,1,3,0.14,1.029
longpower,63,91.071,1,0,1,0.113,1.024
blavaan,121,93.97,3,4,7,0.076,1.017
cubature,374,96.659,59,14,73,0.017,1.016
sem,336,96.486,7,4,11,0.048,1.016
glmmML,124,94.053,4,1,5,0.062,1.004
dotwhisker,89,92.963,1,4,5,0.066,0.997
clusterPower,23,76.424,0,0,0,0.218,0.982
lqmm,83,92.66,2,2,4,0.051,0.978
VetResearchLMM,33,84.588,0,0,0,0.126,0.972
multgee,93,93.093,1,2,3,0.037,0.969
pedigreemm,47,88.018,1,2,3,0.072,0.953
SASmixed,31,83.615,0,2,2,0.106,0.942
kinship2,77,92.283,18,6,24,0.007,0.94
glmertree,36,85.632,1,2,3,0.062,0.918
MplusAutomation,61,90.819,10,3,13,0,0.914
glmm.hp,30,83.027,0,0,0,0.079,0.91
lmeresampler,23,76.424,0,0,0,0.14,0.904
geeM,43,87.259,4,1,5,0.026,0.901
r2glmm,18,62.634,0,1,1,0.26,0.886
aods3,29,82.286,1,1,2,0.062,0.885
asremlPlus,27,80.86,0,0,0,0.077,0.885
CARBayesST,31,83.615,1,0,1,0.048,0.884
sphet,31,83.615,2,0,2,0.045,0.882
semtree,29,82.286,0,0,0,0.056,0.879
mixlm,24,77.948,2,0,2,0.097,0.878
CpGassoc,30,83.027,1,0,1,0.045,0.876
StroupGLMM,18,62.634,0,0,0,0.235,0.861
LMERConvenienceFunctions,23,76.424,0,0,0,0.092,0.856
biglmm,34,84.98,0,2,2,0,0.85
repeated,33,84.588,0,0,0,0,0.846
RPEGLMEN,32,84.146,1,0,1,0,0.842
blmeco,21,72.281,0,0,0,0.109,0.832
sparseFLMM,22,74.471,2,0,2,0.078,0.823
varTestnlme,20,69.638,0,0,0,0.124,0.82
nlmeU,22,74.471,2,1,3,0.071,0.817
rlme,19,66.418,0,0,0,0.122,0.786
pez,21,72.281,0,1,1,0.062,0.784
glmmSeq,18,62.634,0,0,0,0.145,0.771
spind,20,69.638,0,0,0,0.062,0.759
GLMMRR,20,69.638,0,0,0,0.062,0.758
saemix,20,69.638,2,0,2,0.055,0.753
mlmmm,22,74.471,0,0,0,0,0.745
glmmLasso,22,74.471,1,0,1,0,0.745
LMest,20,69.638,0,0,0,0.048,0.744
wgeesel,19,66.418,1,0,1,0.059,0.724
CRTgeeDR,19,66.418,1,0,1,0.051,0.716
MM4LMM,19,66.418,1,0,1,0.048,0.712
skewlmm,19,66.418,0,0,0,0.045,0.709
glmm,20,69.638,0,0,0,0,0.696
inlabru,19,66.418,2,0,2,0.03,0.695
denseFLMM,17,57.685,1,0,1,0.078,0.655
influence.ME,17,57.685,0,0,0,0.062,0.638
lmm,18,62.634,0,0,0,0,0.626
ARpLMEC,17,57.685,0,0,0,0.048,0.624
lmeSplines,17,57.685,0,0,0,0.045,0.622
CLME,15,46.579,0,0,0,0.154,0.62
iccbeta,16,52.526,0,0,0,0.071,0.596
glmmfields,16,52.526,0,0,0,0.065,0.59
pass.lme,17,57.685,0,0,0,0,0.577
DGLMExtPois,17,57.685,0,0,0,0,0.577
mvglmmRank,16,52.526,0,0,0,0.048,0.573
lmmot,16,52.526,0,0,0,0.048,0.573
MarginalMediation,16,52.526,0,0,0,0,0.525
hglm,15,46.579,0,0,0,0.048,0.513
glmmPen,14,39.151,0,0,0,0.109,0.501
geesmv,14,39.151,0,0,0,0.099,0.49
gfilmm,14,39.151,0,0,0,0.088,0.479
QGglmm,15,46.579,0,0,0,0.001,0.467
lmmpar,14,39.151,0,0,0,0.048,0.439
splmm,14,39.151,0,0,0,0.048,0.439
Phxnlme,14,39.151,0,0,0,0,0.392
LMMsolver,14,39.151,1,0,1,0,0.392
robustBLME,13,32.673,0,0,0,0.062,0.388
mixedsde,13,32.673,0,0,0,0.048,0.374
LMMstar,11,19.149,0,0,0,0.162,0.354
glmmEP,12,26.95,0,0,0,0.076,0.345
nlmeVPC,13,32.673,0,0,0,0,0.327
glme,11,19.149,0,0,0,0.045,0.236
nlmm,8,10.616,0,0,0,0.095,0.202
trouBBlme4SolveR,7,8.938,0,0,0,0.106,0.196
LMMELSM,7,8.938,0,0,0,0.092,0.182
mlmm.gwas,10,14.559,0,0,0,0.007,0.153
MCMC.qpcr,10,14.559,0,0,0,0.005,0.151
pwlmm,6,5.457,0,0,0,0.062,0.116
MASS,NA,NA,1836,602,2438,0.773,NA
